1111111111
101E11C111
10000000C1
10P0C00C01
1111111111
