1111111111
1D00C001D1
1001000101
1101010001
1001000101
1011101101
1C01E00101
1111111101
1000100001
1000100101
1010001101
10001P0101
1C0D101111
10001D0001
1111111111
