1111111111
1D1E11C111
10000000C1
1DP0C00C01
1111111111
