1111111111
1D000110C1
1000000001
10P0E00011
100C000001
1111111111
