1111111111
1000C00101
1001000101
1101010001
1001000101
1011101101
1C01E00101
1111111101
1000100001
1000100101
1010001101
10001P0101
1C00101111
1000100001
1111111111
