1111111111
1P1E10C111
10010000C1
10000000C1
1111111111
